############
#..........#
#..........#
#..........#
#.....M....#
#...====...#
#..........#
#..........#
#..........#
#D.C.......#
#..........#
############
